 delete all x here to win! 
 x  x 
 x     x       x
     x     x
     x              x
    x       x
          x                   x
x           x   x
    